xxxxxxxxxxxxxxxxxxxxx
xx..................x
xx.xxxxxxxxxxxxxxxx.x
xx.x       b      x.x
xx.xxxxxxxxxxxxxxxx.x
xx......p...........x
xx.x.x.x.x.x.x.x.x..x
xx.x.x.x.x.x.x.x.xxxx
xx.x.x.x.x.x.x.x.x..x
