xxxxxxxxxxxxxxxxxxx
x....x.......x....x
x.xx x xxxxx x.xx.x
x.x.............x.x
x.x.xx xx xx xx.x.x
x......xEE x .....x
x.x.xx xxxxx xx x.x
x.x.............x.x
x.xx x xxxxx x xx.x
xp..xx.......x....x
xxxxxxxxxxxxxxxxxxx